BspWrd —— backspace entire word
CapsWd –– CAPS word
###### –– key held to activate layer
DTT    —— Dynamic Tap Term adjustments
HRM    —— Home Row Mods (tap/hold)

COLEMAK
,-----------------------------------------------------------------------------------.
|   `  |   1  |   2  |   3  |   4  |   5  |   6  |   7  |   8  |   9  |   0  |BspWrd| 
|------+------+------+------+------+------+------+------+------+------+------+------|
|   ⇥  |   Q  |   W  |   F  |   P  |   B  |   J  |   L  |   U  |   Y  |   ;  |  Del |
|------+------+------+------+------+------+------+------+------+------+------+------|
|  Esc |   A  |   R  |   S  |   T  |   G  |   M  |   N  |   E  |   I  |   O  |   '  |
|------+------+------+------+------+------+------+------+------+------+------+------|
|   ⇧  |   Z  |   X  |   C  |   D  |   V  |   K  |   H  |   ,  |   .  |   /  |   ⏎  |
|------+------+------+------+------+------+------+------+------+------+------+------|
|      |      |      |   ⇥  |   ␣  |   E  |      |   ⌫  | Enter|      |      |      | 
`-----------------------------------------------------------------------------------'
held (home row mods enabled):
,-----------------------------------------------------------------------------------.
|      |      |      |      |      |      |      |      |      |      |      |      |
|------+------+------+------+------+------+------+------+------+------+------+------|
|  Meh |      |      |      |      |      |      |      |      |      |   ⌥  |  Meh |
|------+------+------+------+------+------+------+------+------+------+------+------|
|   ⌃  |   ⌃  |   ⌥  |   ⌘  |   ⇧  |      |      |   ⇧  |   ⌘  |   ⌥  |   ⌃  |   ⌃  |
|------+------+------+------+------+------+------+------+------+------+------+------| 
|   ⇧  |      |      |      |      |      |      |      |   ⌘  |   ⌥  |   ⌃  |   ⇧  |
|------+------+------+------+------+------+------+------+------+------+------+------|
|  Fn  |   ⌃  |   ⌥  |   ⌘  |  NUM |  FUN |  NAV |   ⇧  |  PTR |      |      |      |
`-----------------------------------------------------------------------------------'

NUMBERS
,-----------------------------------------------------------------------------------.
|      |      |      |      |      |      |      |      |      |      |      |      |
|------+------+------+------+------+------+------+------+------+------+------+------|
|   `  |   !  |   @  |   #  |   _  |   (  |   )  |   7  |   8  |   9  |   *  |   &  |
|------+------+------+------+------+------+------+------+------+------+------+------|
| Dict |   ⌃  |   ⌥  |   ⌘  |   ⇧  |   [  |   ]  |   4  |   5  |   6  |   0  |   +  |
|------+------+------+------+------+------+------+------+------+------+------+------|
|      |   \  |   [  |   ]  |   -  |   =  |   :  |   1  |   2  |   3  |   /  |   ⏎  | 
|------+------+------+------+------+------+------+------+------+------+------+------|
|      |      |      | Em — |######|      |   0  |   ⌫  |   .  |      |      |      |
`-----------------------------------------------------------------------------------'

FUNCTION  
,-----------------------------------------------------------------------------------.
|      |      |      |      |      |      |      |      |      |      |      |      |
|------+------+------+------+------+------+------+------+------+------+------+------|
|HRMOff|  F1  |  F2  |  F3  |  F4  |  F5  |  F6  |  F7  |  F8  |  F9  |  F10 |      |
|------+------+------+------+------+------+------+------+------+------+------+------|
|  FN  |  F11 |  F12 |  F13 |  F14 |  F15 |  F16 |  F17 |  F18 |  F19 |  F20 |  FN  |
|------+------+------+------+------+------+------+------+------+------+------+------|
|HRM On| Undo | Cut  | Copy | Paste| Paste|      |      | DTT -| DTT +|PrnDTT|      | 
|------+------+------+------+------+------+------+------+------+------+------+------|
|      |      |      |  GAM |      |######|      |      |      |      |      |      |
`-----------------------------------------------------------------------------------'

NAV
,-----------------------------------------------------------------------------------.
|      |      |      |      |      |      |      |      |      |      |      |      |
|------+------+------+------+------+------+------+------+------+------+------+------|
|      |      |      |      |      |      |      | Back | Cmd -| Cmd =| Fwd  |  whU |
|------+------+------+------+------+------+------+------+------+------+------+------|
| Tab  |   ⌃  |   ⌥  |   ⌘  |   ⇧  |      |  BS  | Left | Down |  Up  | Right|  Del |
|------+------+------+------+------+------+------+------+------+------+------+------|
|   ⇪  | Undo | Cut  | Copy | Paste| Paste|      | Home | PGDN | PGUP | End  |  whD |
|------+------+------+------+------+------+------+------+------+------+------+------|
|      |      |      |  Tab | Spc  |      |######|      |      |      |      |      |
`-----------------------------------------------------------------------------------'


MEDIA
,-----------------------------------------------------------------------------------.
|      |      |      |      |      |      |      |      |      |      |      |      |
|------+------+------+------+------+------+------+------+------+------+------+------|
|      |      |      |      |      |      |      | Prev | VolDn| VolUp| Next | Play |
|------+------+------+------+------+------+------+------+------+------+------+------|
|  FN  |      |      |      |      |      |      |   ⇧  |   ⌘  |   ⌥  |   ⌃  |  FN  |
|------+------+------+------+------+------+------+------+------+------+------+------|
|      |      |      |      |      |      |      | PLY 1| PLY 2| REC 1| REC 2| STOP |
|------+------+------+------+------+------+------+------+------+------+------+------|
|      |      |      |      |  PTR |      |      |      |######|      |      |      |
`-----------------------------------------------------------------------------------'

POINTER
,-----------------------------------------------------------------------------------.
|      |      |      |      |      |      |      |      |      |      |      |      |
|------+------+------+------+------+------+------+------+------+------+------+------|
|      |      |      |      |      |      |      |  whL |  whD |  whU |  whR | EXIT |
|------+------+------+------+------+------+------+------+------+------+------+------|
|      |   ⌃  |   ⌥  |   ⌘  |   ⇧  |      |  b1  |  msL |  msD |  msU |  msR |  b2  | 
|------+------+------+------+------+------+------+------+------+------+------+------|
|      | Undo | Cut  | Copy | Paste| Paste|      |  b1  |  b2  |  b3  |      |      |
|------+------+------+------+------+------+------+------+------+------+------+------|
|      |      |      |      |######|      |  b2  |  b1  |######|      |      |      |
`-----------------------------------------------------------------------------------'
  
QWERTY
,-----------------------------------------------------------------------------------.
|   `  |   1  |   2  |   3  |   4  |   5  |   6  |   7  |   8  |   9  |   0  | Bspc | 
|------+------+------+------+------+------+------+------+------+------+------+------|
| Tab  |   Q  |   W  |   E  |   R  |   T  |   Y  |   U  |   I  |   O  |   P  |  DEL |
|------+------+------+------+------+------+------+------+------+------+------+------|
| Esc  |   A  |   S  |   D  |   F  |   G  |   H  |   J  |   K  |   L  |   ;  |   '  |
|------+------+------+------+------+------+------+------+------+------+------+------|
| Shift|   Z  |   X  |   C  |   V  |   B  |   N  |   M  |   ,  |   .  |   /  |Enter |
|------+------+------+------+------+------+------+------+------+------+------+------|
|      | Ctrl | Alt  | GUI  |  Spc | EXIT | EXIT | Bspc | Left | Down |  Up  |Right |
`-----------------------------------------------------------------------------------'

COMBOS:


wf ➡️ (
fp ➡️ )
xc ➡️ [
cd ➡️ ]

nu ➡️ PTR LOCK
ar ➡️ CAPS WORD
rs ➡️ CMD

ne ➡️ BACKSPACE WORD
uy ➡️ HOME ROW MODIFIERS OFF
ei ➡️ CMD
,. ➡️ HOME ROW MODIFIERS ON
io ➡️

esc del ➡️ RESET

