BspWrd —— backspace entire word
CapsWd –– CAPS word
###### –– key held to activate layer
DTT    —— Dynamic Tap Term adjustments

CMK
,-----------------------------------------------------------------------------------.
|   ⇥  |   Q  |   W  |   F  |   P  |   B  |   J  |   L  |   U  |   Y  |   ;  |  Del |
|------+------+------+------+------+------+------+------+------+------+------+------|
|  Esc |   A  |   R  |   S  |   T  |   G  |   M  |   N  |   E  |   I  |   O  |   '  |
|------+------+------+------+------+------+------+------+------+------+------+------|
|   ⇧  |   Z  |   X  |   C  |   D  |   V  |   K  |   H  |   ,  |   .  |   /  |   ⏎  |
|------+------+------+------+------+------+------+------+------+------+------+------|
|      |      |      |   ⇥  |   ␣  |   E  |      |   ⌫  | Enter|      |      |      | 
`-----------------------------------------------------------------------------------'
held:
,-----------------------------------------------------------------------------------.
| Hyper|      |      |      |      |      |      |      |      |      |      | Hyper|
|------+------+------+------+------+------+------+------+------+------+------+------|
|   ⌃  |   ⌃  |   ⌥  |   ⌘  |   ⇧  |      |      |   ⇧  |   ⌘  |   ⌥  |   ⌃  |   ⌃  |
|------+------+------+------+------+------+------+------+------+------+------+------| 
|   ⇧  |  Meh |      |      |  MOD |      |      |  MOD |      |      |  Meh |   ⇧  |
|------+------+------+------+------+------+------+------+------+------+------+------|
|  Fn  |   ⌃  |   ⌥  |   ⌘  |  NUM |  FUN |  NAV |   ⇧  |  PTR |      |      |      |
`-----------------------------------------------------------------------------------'

NUM
,-----------------------------------------------------------------------------------.
|   `  |   !  |   @  |   #  |   _  |   (  |   )  |   7  |   8  |   9  |   *  |   &  |
|------+------+------+------+------+------+------+------+------+------+------+------|
| Dict |   ⌃  |   ⌥  |   ⌘  |   ⇧  |   [  |   ]  |   4  |   5  |   6  |   0  |   +  |
|------+------+------+------+------+------+------+------+------+------+------+------|
|      |   \  |   [  |   ]  |   -  |   =  |   :  |   1  |   2  |   3  |   /  |   ⏎  | 
|------+------+------+------+------+------+------+------+------+------+------+------|
|      |      |      | Em — |######|      |   0  |   ⌫  |   .  |      |      |      |
`-----------------------------------------------------------------------------------'

FUN  
,-----------------------------------------------------------------------------------.
|      |  F1  |  F2  |  F3  |  F4  |  F5  |  F6  |  F7  |  F8  |  F9  |  F10 |      |
|------+------+------+------+------+------+------+------+------+------+------+------|
|  FN  |  F11 |  F12 |  F13 |  F14 |  F15 |  F16 |  F17 |  F18 |  F19 |  F20 |  FN  |
|------+------+------+------+------+------+------+------+------+------+------+------|
|      | Undo | Cut  | Copy | Paste| Paste|      |      | DTT -| DTT +|PrnDTT|      | 
|------+------+------+------+------+------+------+------+------+------+------+------|
|      |      |      |  GAM |      |######|      |      |      |      |      |      |
`-----------------------------------------------------------------------------------'

NAV
,-----------------------------------------------------------------------------------.
|      | Prev | VolDn| VolUp| Next | Mute |      | Back | Cmd -| Cmd =| Fwd  |  whU |
|------+------+------+------+------+------+------+------+------+------+------+------|
| Tab  |   ⌃  |   ⌥  |   ⌘  |   ⇧  | Play |  BS  | Left | Down |  Up  | Right|  Del |
|------+------+------+------+------+------+------+------+------+------+------+------|
|   ⇪  | Undo | Cut  | Copy | Paste| Paste|      | Home | PGDN | PGUP | End  |  whD |
|------+------+------+------+------+------+------+------+------+------+------+------|
|      |      |      |  Tab | Spc  |      |######|      |      |      |      |      |
`-----------------------------------------------------------------------------------'

PTR 
,-----------------------------------------------------------------------------------.
|      |      |      |      |      |      |      |  whL |  whD |  whU |  whR | EXIT |
|------+------+------+------+------+------+------+------+------+------+------+------|
|      |   ⌃  |   ⌥  |   ⌘  |   ⇧  |      |  b1  |  msL |  msD |  msU |  msR |  b2  | 
|------+------+------+------+------+------+------+------+------+------+------+------|
|      | Undo | Cut  | Copy | Paste| Paste|      |  b1  |  b2  |  b3  |      |      |
|------+------+------+------+------+------+------+------+------+------+------+------|
|      |      |      |      | Spc  |      |  b2  |  b1  |######|      |      |      |
`-----------------------------------------------------------------------------------'
  
_____________

GAM
,-----------------------------------------------------------------------------------.
| Tab  |   Q  |   W  |   E  |   R  |   T  |   Y  |   U  |   I  |   O  |   P  |  DEL |
|------+------+------+------+------+------+------+------+------+------+------+------|
| Esc  |   A  |   S  |   D  |   F  |   G  |   H  |   J  |   K  |   L  |   ;  |   '  |
|------+------+------+------+------+------+------+------+------+------+------+------|
| Shift|   Z  |   X  |   C  |   V  |   B  |   N  |   M  |   ,  |   .  |   /  |Enter |
|------+------+------+------+------+------+------+------+------+------+------+------|
|      | Ctrl | Alt  | GUI  |  Spc | EXIT | EXIT | Bspc | Left | Down |  Up  |Right |
`-----------------------------------------------------------------------------------'

___

COMBOS:

i/ ➡️ PTR LOCK
ar ➡️ CAPS WORD
ne ➡️ BACKSPACE WORD

esc del ➡️ RESET
